repraderholt	Rep. ROBERT B. ADERHOLT, R-Ala.
reppaguilar	Rep. PETE AGUILAR, D-Calif.
repmalford	Rep. MARK ALFORD, R-Mo.
reprallen	Rep. RICK W. ALLEN, R-Ga.
repgamo	Rep. GABE AMO, D-R.I.
repmamodei	Rep. MARK E. AMODEI, R-Nev.
repyansari	Rep. YASSAMIN ANSARI, D-Ariz.
repjarrington	Rep. JODEY C. ARRINGTON, R-Texas
repjauchincloss	Rep. JAKE AUCHINCLOSS, D-Mass.
repbbabin	Rep. BRIAN BABIN, R-Texas
repdbacon	Rep. DON BACON, R-Neb.
repjbaird	Rep. JAMES R. BAIRD, R-Ind.
reptbalderson	Rep. TROY BALDERSON, R-Ohio
repbbalint	Rep. BECCA BALINT, D-Vt.
repabarr	Rep. ANDY BARR, R-Ky.
repnbarragán	Rep. NANETTE DIAZ BARRAGÁN, D-Calif.
reptbarrett	Rep. TOM BARRETT, R-Mich.
repmbaumgartner	Rep. MICHAEL BAUMGARTNER, R-Wash.
repabean	Rep. AARON BEAN, R-Fla.
repjbeatty	Rep. JOYCE BEATTY, D-Ohio
repnbegich	Rep. NICHOLAS J. BEGICH III, R-Alaska
repwbell	Rep. WESLEY BELL, D-Mo.
repcbentz	Rep. CLIFF BENTZ, R-Ore.
repabera	Rep. AMI BERA, D-Calif.
repjbergman	Rep. JACK BERGMAN, R-Mich.
repdbeyer	Rep. DONALD S. BEYER JR., D-Va.
repsbice	Rep. STEPHANIE I. BICE, R-Okla.
repabiggs	Rep. ANDY BIGGS, R-Ariz.
repsbiggs	Rep. SHERI BIGGS, R-S.C.
repgbilirakis	Rep. GUS M. BILIRAKIS, R-Fla.
repsbishop	Rep. SANFORD D. BISHOP JR., D-Ga.
replboebert	Rep. LAUREN BOEBERT, R-Colo.
repsbonamici	Rep. SUZANNE BONAMICI, D-Ore.
repmbost	Rep. MIKE BOST, R-Ill.
repbboyle	Rep. BRENDAN F. BOYLE, D-Pa.
repjbrecheen	Rep. JOSH BRECHEEN, R-Okla.
reprbresnahan	Rep. ROBERT P. BRESNAHAN JR., R-Pa.
repsbrown	Rep. SHONTEL M. BROWN, D-Ohio
repjbrownley	Rep. JULIA BROWNLEY, D-Calif.
repvbuchanan	Rep. VERN BUCHANAN, R-Fla.
repnbudzinski	Rep. NIKKI BUDZINSKI, D-Ill.
reptburchett	Rep. TIM BURCHETT, R-Tenn.
repeburlison	Rep. ERIC BURLISON, R-Mo.
repjbynum	Rep. JANELLE S. BYNUM, D-Ore.
repkcalvert	Rep. KEN CALVERT, R-Calif.
repkcammack	Rep. KAT CAMMACK, R-Fla.
repscarbajal	Rep. SALUD O. CARBAJAL, D-Calif.
repmcarey	Rep. MIKE CAREY, R-Ohio
repacarson	Rep. ANDRÉ CARSON, D-Ind.
repecarter	Rep. EARL L. "BUDDY" CARTER, R-Ga.
repjcarter	Rep. JOHN R. CARTER, R-Texas
reptcarter	Rep. TROY A. CARTER, D-La.
repgcasar	Rep. GREG CASAR, D-Texas
repecase	Rep. ED CASE, D-Hawaii
repscasten	Rep. SEAN CASTEN, D-Ill.
repkcastor	Rep. KATHY CASTOR, D-Fla.
repjcastro	Rep. JOAQUIN CASTRO, D-Texas
repscherfilus-mccormick	Rep. SHEILA CHERFILUS-MCCORMICK, D-Fla.
repjchu	Rep. JUDY CHU, D-Calif.
repjciscomani	Rep. JUAN CISCOMANI, R-Ariz.
repgcisneros	Rep. GILBERT RAY CISNEROS JR., D-Calif.
repkclark	Rep. KATHERINE M. CLARK, D-Mass.
repyclarke	Rep. YVETTE D. CLARKE, D-N.Y.
repecleaver	Rep. EMANUEL CLEAVER, D-Mo.
repbcline	Rep. BEN CLINE, R-Va.
repmcloud	Rep. MICHAEL CLOUD, R-Texas
repjclyburn	Rep. JAMES E. CLYBURN, D-S.C.
repaclyde	Rep. ANDREW S. CLYDE, R-Ga.
repscohen	Rep. STEVE COHEN, D-Tenn.
reptcole	Rep. TOM COLE, R-Okla.
repmcollins	Rep. MIKE COLLINS, R-Ga.
repjcomer	Rep. JAMES COMER, R-Ky.
rephconaway	Rep. HERBERT C. CONAWAY JR., D-N.J.
repgconnolly	Rep. GERALD E. CONNOLLY, D-Va.
repjcorrea	Rep. J. LUIS CORREA, D-Calif.
repjcosta	Rep. JIM COSTA, D-Calif.
repjcourtney	Rep. JOE COURTNEY, D-Conn.
repacraig	Rep. ANGIE CRAIG, D-Minn.
repecrane	Rep. ELIJAH CRANE, R-Ariz.
repjcrank	Rep. JEFF CRANK, R-Colo.
repecrawford	Rep. ERIC A. "RICK" CRAWFORD, R-Ark.
repdcrenshaw	Rep. DAN CRENSHAW, R-Texas
repjcrockett	Rep. JASMINE CROCKETT, D-Texas
repjcrow	Rep. JASON CROW, D-Colo.
rephcuellar	Rep. HENRY CUELLAR, D-Texas
repsdavids	Rep. SHARICE DAVIDS, D-Kan.
repwdavidson	Rep. WARREN DAVIDSON, R-Ohio
repddavis	Rep. DANNY K. DAVIS, D-Ill.
repdgdavis	Rep. DONALD G. DAVIS, D-N.C.
repmdelacruz	Rep. MONICA DE LA CRUZ, R-Texas
repmdean	Rep. MADELEINE DEAN, D-Pa.
repddegette	Rep. DIANA DEGETTE, D-Colo.
reprdelauro	Rep. ROSA L. DELAURO, D-Conn.
repsdelbene	Rep. SUZAN K. DELBENE, D-Wash.
repcdeluzio	Rep. CHRISTOPHER R. DELUZIO, D-Pa.
repmdesaulnier	Rep. MARK DESAULNIER, D-Calif.
repsdesjarlais	Rep. SCOTT DESJARLAIS, R-Tenn.
repmdexter	Rep. MAXINE DEXTER, D-Ore.
repmdiaz-balart	Rep. MARIO DIAZ-BALART, R-Fla.
repddingell	Rep. DEBBIE DINGELL, D-Mich.
repldoggett	Rep. LLOYD DOGGETT, D-Texas
repbdonalds	Rep. BYRON DONALDS, R-Fla.
reptdowning	Rep. TROY DOWNING, R-Mont.
repndunn	Rep. NEAL P. DUNN, R-Fla.
repcedwards	Rep. CHUCK EDWARDS, R-N.C.
repselfreth	Rep. SARAH ELFRETH, D-Md.
repjellzey	Rep. JAKE ELLZEY, R-Texas
reptemmer	Rep. TOM EMMER, R-Minn.
repvescobar	Rep. VERONICA ESCOBAR, D-Texas
repaespaillat	Rep. ADRIANO ESPAILLAT, D-N.Y.
represtes	Rep. RON ESTES, R-Kan.
repdevans	Rep. DWIGHT EVANS, D-Pa.
repgevans	Rep. GABE EVANS, R-Colo.
repmezell	Rep. MIKE EZELL, R-Miss.
reppfallon	Rep. PAT FALLON, R-Texas
repjfedorchak	Rep. JULIE FEDORCHAK, R-N.D.
reprfeenstra	Rep. RANDY FEENSTRA, R-Iowa
repcfields	Rep. CLEO FIELDS, D-La.
repsfigures	Rep. SHOMARI FIGURES, D-Ala.
repbfinstad	Rep. BRAD FINSTAD, R-Minn.
repmfischbach	Rep. MICHELLE FISCHBACH, R-Minn.
repsfitzgerald	Rep. SCOTT FITZGERALD, R-Wis.
repbfitzpatrick	Rep. BRIAN K. FITZPATRICK, R-Pa.
repcfleischmann	Rep. CHARLES J. "CHUCK" FLEISCHMANN, R-Tenn.
replfletcher	Rep. LIZZIE FLETCHER, D-Texas
repmflood	Rep. MIKE FLOOD, R-Neb.
repvfong	Rep. VINCE FONG, R-Calif.
repbfoster	Rep. BILL FOSTER, D-Ill.
repvfoushee	Rep. VALERIE P. FOUSHEE, D-N.C.
repvfoxx	Rep. VIRGINIA FOXX, R-N.C.
replfrankel	Rep. LOIS FRANKEL, D-Fla.
repsfranklin	Rep. SCOTT FRANKLIN, R-Fla.
replfriedman	Rep. LAURA FRIEDMAN, D-Calif.
repmfrost	Rep. MAXWELL FROST, D-Fla.
reprfry	Rep. RUSSELL FRY, R-S.C.
reprfulcher	Rep. RUSS FULCHER, R-Idaho
repjgaramendi	Rep. JOHN GARAMENDI, D-Calif.
repagarbarino	Rep. ANDREW R. GARBARINO, R-N.Y.
reprgarcia	Rep. ROBERT GARCIA, D-Calif.
repsgarcia	Rep. SYLVIA R. GARCIA, D-Texas
repjgarcía	Rep. JESÚS G. "CHUY" GARCÍA, D-Ill.
repbgill	Rep. BRANDON GILL, R-Texas
replgillen	Rep. LAURA GILLEN, D-N.Y.
repcgimenez	Rep. CARLOS A. GIMENEZ, R-Fla.
repjgolden	Rep. JARED F. GOLDEN, D-Maine
repcgoldman	Rep. CRAIG A. GOLDMAN, R-Texas
repdgoldman	Rep. DANIEL S. GOLDMAN, D-N.Y.
repjgomez	Rep. JIMMY GOMEZ, D-Calif.
reptgonzales	Rep. TONY GONZALES, R-Texas
repvgonzalez	Rep. VICENTE GONZALEZ, D-Texas
replgooden	Rep. LANCE GOODEN, R-Texas
repmgoodlander	Rep. MAGGIE GOODLANDER, D-N.H.
reppgosar	Rep. PAUL A. GOSAR, R-Ariz.
repjgottheimer	Rep. JOSH GOTTHEIMER, D-N.J.
repsgraves	Rep. SAM GRAVES, R-Mo.
repagray	Rep. ADAM GRAY, D-Calif.
repagreen	Rep. AL GREEN, D-Texas
repmgreen	Rep. MARK E. GREEN, R-Tenn.
repmgreene	Rep. MARJORIE TAYLOR GREENE, R-Ga.
rephgriffith	Rep. H. MORGAN GRIFFITH, R-Va.
reprgrijalva	Rep. RAÚL M. GRIJALVA, D-Ariz.
repggrothman	Rep. GLENN GROTHMAN, R-Wis.
repmguest	Rep. MICHAEL GUEST, R-Miss.
repbguthrie	Rep. BRETT GUTHRIE, R-Ky.
rephhageman	Rep. HARRIET M. HAGEMAN, R-Wyo.
repahamadeh	Rep. ABRAHAM J. HAMADEH, R-Ariz.
repjharder	Rep. JOSH HARDER, D-Calif.
repmharidopolos	Rep. MIKE HARIDOPOLOS, R-Fla.
reppharrigan	Rep. PAT HARRIGAN, R-N.C.
repaharris	Rep. ANDY HARRIS, R-Md.
repmharris	Rep. MARK HARRIS, R-N.C.
repdharshbarger	Rep. DIANA HARSHBARGER, R-Tenn.
repjhayes	Rep. JAHANA HAYES, D-Conn.
repkhern	Rep. KEVIN HERN, R-Okla.
repphernández	Rep. PABLO JOSÉ HERNÁNDEZ, D-Puerto Rico"
repchiggins	Rep. CLAY HIGGINS, R-La.
repjhill	Rep. J. FRENCH HILL, R-Ark.
repjhimes	Rep. JAMES A. HIMES, D-Conn.
repahinson	Rep. ASHLEY HINSON, R-Iowa
repshorsford	Rep. STEVEN HORSFORD, D-Nev.
repehouchin	Rep. ERIN HOUCHIN, R-Ind.
repchoulahan	Rep. CHRISSY HOULAHAN, D-Pa.
repshoyer	Rep. STENY H. HOYER, D-Md.
repvhoyle	Rep. VAL T. HOYLE, D-Ore.
reprhudson	Rep. RICHARD HUDSON, R-N.C.
repjhuffman	Rep. JARED HUFFMAN, D-Calif.
repbhuizenga	Rep. BILL HUIZENGA, R-Mich.
repwhunt	Rep. WESLEY HUNT, R-Texas
repjhurd	Rep. JEFF HURD, R-Colo.
repdissa	Rep. DARRELL ISSA, R-Calif.
repgivey	Rep. GLENN IVEY, D-Md.
repbjack	Rep. BRIAN JACK, R-Ga.
repjjackson	Rep. JONATHAN L. JACKSON, D-Ill.
reprjackson	Rep. RONNY JACKSON, R-Texas
repsjacobs	Rep. SARA JACOBS, D-Calif.
repjjames	Rep. JOHN JAMES, R-Mich.
reppjayapal	Rep. PRAMILA JAYAPAL, D-Wash.
rephjeffries	Rep. HAKEEM S. JEFFRIES, D-N.Y.
repdjohnson	Rep. DUSTY JOHNSON, R-S.D.
rephjohnson	Rep. HENRY C. "HANK" JOHNSON JR., D-Ga.
repjjohnson	Rep. JULIE JOHNSON, D-Texas
repmjohnson	Rep. MIKE JOHNSON, R-La.
repjjordan	Rep. JIM JORDAN, R-Ohio
repdjoyce	Rep. DAVID P. JOYCE, R-Ohio
repjjoyce	Rep. JOHN JOYCE, R-Pa.
repskamlager-dove	Rep. SYDNEY KAMLAGER-DOVE, D-Calif.
repmkaptur	Rep. MARCY KAPTUR, D-Ohio
reptkean	Rep. THOMAS H. KEAN JR., R-N.J.
repwkeating	Rep. WILLIAM R. KEATING, D-Mass.
repmkelly	Rep. MIKE KELLY, R-Pa.
reprkelly	Rep. ROBIN L. KELLY, D-Ill.
reptkelly	Rep. TRENT KELLY, R-Miss.
repmkennedy	Rep. MIKE KENNEDY, R-Utah
reptkennedy	Rep. TIMOTHY M. KENNEDY, D-N.Y.
reprkhanna	Rep. RO KHANNA, D-Calif.
repjkiggans	Rep. JENNIFER A. KIGGANS, R-Va.
repkkiley	Rep. KEVIN KILEY, R-Calif.
repykim	Rep. YOUNG KIM, R-Calif.
repkking-hinds	Rep. KIMBERLYN KING-HINDS, R-Northern Mariana Islands"
repbknott	Rep. BRAD KNOTT, R-N.C.
reprkrishnamoorthi	Rep. RAJA KRISHNAMOORTHI, D-Ill.
repdkustoff	Rep. DAVID KUSTOFF, R-Tenn.
repdlahood	Rep. DARIN LAHOOD, R-Ill.
repnlalota	Rep. NICK LALOTA, R-N.Y.
repdlamalfa	Rep. DOUG LAMALFA, R-Calif.
repglandsman	Rep. GREG LANDSMAN, D-Ohio
repnlangworthy	Rep. NICHOLAS A. LANGWORTHY, R-N.Y.
reprlarsen	Rep. RICK LARSEN, D-Wash.
repjlarson	Rep. JOHN B. LARSON, D-Conn.
repglatimer	Rep. GEORGE LATIMER, D-N.Y.
reprlatta	Rep. ROBERT E. LATTA, R-Ohio
repmlawler	Rep. MICHAEL LAWLER, R-N.Y.
repllee	Rep. LAUREL M. LEE, R-Fla.
repsllee	Rep. SUMMER L. LEE, D-Pa.
repslee	Rep. SUSIE LEE, D-Nev.
reptlegerfernandez	Rep. TERESA LEGER FERNANDEZ, D-N.M.
repjletlow	Rep. JULIA LETLOW, R-La.
repmlevin	Rep. MIKE LEVIN, D-Calif.
repsliccardo	Rep. SAM T. LICCARDO, D-Calif.
reptlieu	Rep. TED LIEU, D-Calif.
repzlofgren	Rep. ZOE LOFGREN, D-Calif.
repbloudermilk	Rep. BARRY LOUDERMILK, R-Ga.
repflucas	Rep. FRANK D. LUCAS, R-Okla.
repaluna	Rep. ANNA PAULINA LUNA, R-Fla.
repmluttrell	Rep. MORGAN LUTTRELL, R-Texas
repslynch	Rep. STEPHEN F. LYNCH, D-Mass.
repnmace	Rep. NANCY MACE, R-S.C.
reprmackenzie	Rep. RYAN MACKENZIE, R-Pa.
repsmagaziner	Rep. SETH MAGAZINER, D-R.I.
repnmalliotakis	Rep. NICOLE MALLIOTAKIS, R-N.Y.
repcmaloy	Rep. CELESTE MALOY, R-Utah
reptmann	Rep. TRACEY MANN, R-Kan.
repjmannion	Rep. JOHN W. MANNION, D-N.Y.
reptmassie	Rep. THOMAS MASSIE, R-Ky.
repbmast	Rep. BRIAN J. MAST, R-Fla.
repdmatsui	Rep. DORIS O. MATSUI, D-Calif.
replmcbath	Rep. LUCY MCBATH, D-Ga.
repsmcbride	Rep. SARAH MCBRIDE, D-Del.
repmmccaul	Rep. MICHAEL T. MCCAUL, R-Texas
repamcclaindelaney	Rep. APRIL MCCLAIN DELANEY, D-Md.
replmcclain	Rep. LISA C. MCCLAIN, R-Mich.
repjmcclellan	Rep. JENNIFER L. MCCLELLAN, D-Va.
reptmcclintock	Rep. TOM MCCLINTOCK, R-Calif.
repbmccollum	Rep. BETTY MCCOLLUM, D-Minn.
reprmccormick	Rep. RICHARD MCCORMICK, R-Ga.
repkmcdonaldrivet	Rep. KRISTEN MCDONALD RIVET, D-Mich.
repamcdowell	Rep. ADDISON P. MCDOWELL, R-N.C.
repmmcgarvey	Rep. MORGAN MCGARVEY, D-Ky.
repjmcgovern	Rep. JAMES P. MCGOVERN, D-Mass.
repjmcguire	Rep. JOHN J. MCGUIRE III, R-Va.
replmciver	Rep. LAMONICA MCIVER, D-N.J.
repgmeeks	Rep. GREGORY W. MEEKS, D-N.Y.
reprmenendez	Rep. ROBERT MENENDEZ, D-N.J.
repgmeng	Rep. GRACE MENG, D-N.Y.
repmmessmer	Rep. MARK B. MESSMER, R-Ind.
repdmeuser	Rep. DANIEL MEUSER, R-Pa.
repkmfume	Rep. KWEISI MFUME, D-Md.
repcmiller	Rep. CAROL D. MILLER, R-W.Va.
repmemiller	Rep. MARY E. MILLER, R-Ill.
repmmiller	Rep. MAX L. MILLER, R-Ohio
repmmiller-meeks	Rep. MARIANNETTE MILLER-MEEKS, R-Iowa
repcmills	Rep. CORY MILLS, R-Fla.
repdmin	Rep. DAVE MIN, D-Calif.
repjmoolenaar	Rep. JOHN R. MOOLENAAR, R-Mich.
repbmoore	Rep. BARRY MOORE, R-Ala.
repbdmoore	Rep. BLAKE D. MOORE, R-Utah
repgmoore	Rep. GWEN MOORE, D-Wis.
reprmoore	Rep. RILEY M. MOORE, R-W.Va.
reptmoore	Rep. TIM MOORE, R-N.C.
repnmoran	Rep. NATHANIEL MORAN, R-Texas
repjmorelle	Rep. JOSEPH D. MORELLE, D-N.Y.
repkmorrison	Rep. KELLY MORRISON, D-Minn.
repjmoskowitz	Rep. JARED MOSKOWITZ, D-Fla.
repsmoulton	Rep. SETH MOULTON, D-Mass.
repjmoylan	Rep. JAMES C. MOYLAN, R-Guam"
repfmrvan	Rep. FRANK J. MRVAN, D-Ind.
repkmullin	Rep. KEVIN MULLIN, D-Calif.
repgmurphy	Rep. GREGORY F. MURPHY, R-N.C.
repjnadler	Rep. JERROLD NADLER, D-N.Y.
reprneal	Rep. RICHARD E. NEAL, D-Mass.
repjneguse	Rep. JOE NEGUSE, D-Colo.
reptnehls	Rep. TROY E. NEHLS, R-Texas
repdnewhouse	Rep. DAN NEWHOUSE, R-Wash.
repdnorcross	Rep. DONALD NORCROSS, D-N.J.
reprnorman	Rep. RALPH NORMAN, R-S.C.
repenorton	Rep. ELEANOR HOLMES NORTON, D-District of Columbia"
repznunn	Rep. ZACHARY NUNN, R-Iowa
repjobernolte	Rep. JAY OBERNOLTE, R-Calif.
repaocasio-cortez	Rep. ALEXANDRIA OCASIO-CORTEZ, D-N.Y.
repaogles	Rep. ANDREW OGLES, R-Tenn.
repjolszewski	Rep. JOHNNY OLSZEWSKI JR., D-Md.
repiomar	Rep. ILHAN OMAR, D-Minn.
repronder	Rep. ROBERT F. ONDER JR., R-Mo.
repbowens	Rep. BURGESS OWENS, R-Utah
repfpallone	Rep. FRANK PALLONE JR., D-N.J.
repgpalmer	Rep. GARY J. PALMER, R-Ala.
repjpanetta	Rep. JIMMY PANETTA, D-Calif.
repcpappas	Rep. CHRIS PAPPAS, D-N.H.
repnpelosi	Rep. NANCY PELOSI, D-Calif.
repmperez	Rep. MARIE GLUESENKAMP PEREZ, D-Wash.
repsperry	Rep. SCOTT PERRY, R-Pa.
repspeters	Rep. SCOTT H. PETERS, D-Calif.
repbpettersen	Rep. BRITTANY PETTERSEN, D-Colo.
repapfluger	Rep. AUGUST PFLUGER, R-Texas
repcpingree	Rep. CHELLIE PINGREE, D-Maine
repsplaskett	Rep. STACEY E. PLASKETT, D-Virgin Islands"
repmpocan	Rep. MARK POCAN, D-Wis.
repnpou	Rep. NELLIE POU, D-N.J.
repapressley	Rep. AYANNA PRESSLEY, D-Mass.
repmquigley	Rep. MIKE QUIGLEY, D-Ill.
reparadewagen	Rep. AUMUA AMATA COLEMAN RADEWAGEN, R-American Samoa"
repdramirez	Rep. DELIA C. RAMIREZ, D-Ill.
reperandall	Rep. EMILY RANDALL, D-Wash.
repjraskin	Rep. JAMIE RASKIN, D-Md.
repgreschenthaler	Rep. GUY RESCHENTHALER, R-Pa.
repjriley	Rep. JOSH RILEY, D-N.Y.
replrivas	Rep. LUZ M. RIVAS, D-Calif.
rephrogers	Rep. HAROLD ROGERS, R-Ky.
repmrogers	Rep. MIKE ROGERS, R-Ala.
repjrose	Rep. JOHN W. ROSE, R-Tenn.
repdross	Rep. DEBORAH K. ROSS, D-N.C.
repdrouzer	Rep. DAVID ROUZER, R-N.C.
repcroy	Rep. CHIP ROY, R-Texas
reprruiz	Rep. RAUL RUIZ, D-Calif.
repmrulli	Rep. MICHAEL A. RULLI, R-Ohio
repjrutherford	Rep. JOHN H. RUTHERFORD, R-Fla.
reppryan	Rep. PATRICK RYAN, D-N.Y.
repmsalazar	Rep. MARIA ELVIRA SALAZAR, R-Fla.
repasalinas	Rep. ANDREA SALINAS, D-Ore.
repsscalise	Rep. STEVE SCALISE, R-La.
repmscanlon	Rep. MARY GAY SCANLON, D-Pa.
repjschakowsky	Rep. JANICE D. SCHAKOWSKY, D-Ill.
repdschmidt	Rep. DEREK SCHMIDT, R-Kan.
repbschneider	Rep. BRADLEY SCOTT SCHNEIDER, D-Ill.
rephscholten	Rep. HILLARY J. SCHOLTEN, D-Mich.
repkschrier	Rep. KIM SCHRIER, D-Wash.
repdschweikert	Rep. DAVID SCHWEIKERT, R-Ariz.
repascott	Rep. AUSTIN SCOTT, R-Ga.
repdscott	Rep. DAVID SCOTT, D-Ga.
reprscott	Rep. ROBERT C. "BOBBY" SCOTT, D-Va.
repkself	Rep. KEITH SELF, R-Texas
reppsessions	Rep. PETE SESSIONS, R-Texas
reptsewell	Rep. TERRI A. SEWELL, D-Ala.
repbsherman	Rep. BRAD SHERMAN, D-Calif.
repmsherrill	Rep. MIKIE SHERRILL, D-N.J.
repjshreve	Rep. JEFFERSON SHREVE, R-Ind.
replsimon	Rep. LATEEFAH SIMON, D-Calif.
repmsimpson	Rep. MICHAEL K. SIMPSON, R-Idaho
repasmith	Rep. ADAM SMITH, D-Wash.
repadrsmith	Rep. ADRIAN SMITH, R-Neb.
repcsmith	Rep. CHRISTOPHER H. SMITH, R-N.J.
repjsmith	Rep. JASON SMITH, R-Mo.
replsmucker	Rep. LLOYD SMUCKER, R-Pa.
repesorensen	Rep. ERIC SORENSEN, D-Ill.
repdsoto	Rep. DARREN SOTO, D-Fla.
repvspartz	Rep. VICTORIA SPARTZ, R-Ind.
repmstansbury	Rep. MELANIE A. STANSBURY, D-N.M.
repgstanton	Rep. GREG STANTON, D-Ariz.
reppstauber	Rep. PETE STAUBER, R-Minn.
repestefanik	Rep. ELISE M. STEFANIK, R-N.Y.
repbsteil	Rep. BRYAN STEIL, R-Wis.
repwsteube	Rep. W. GREGORY STEUBE, R-Fla.
rephstevens	Rep. HALEY M. STEVENS, D-Mich.
repmstrickland	Rep. MARILYN STRICKLAND, D-Wash.
repdstrong	Rep. DALE W. STRONG, R-Ala.
repmstutzman	Rep. MARLIN A. STUTZMAN, R-Ind.
repssubramanyam	Rep. SUHAS SUBRAMANYAM, D-Va.
reptsuozzi	Rep. THOMAS R. SUOZZI, D-N.Y.
repeswalwell	Rep. ERIC SWALWELL, D-Calif.
repesykes	Rep. EMILIA STRONG SYKES, D-Ohio
replsánchez	Rep. LINDA T. SÁNCHEZ, D-Calif.
repmtakano	Rep. MARK TAKANO, D-Calif.
repdtaylor	Rep. DAVID J. TAYLOR, R-Ohio
repctenney	Rep. CLAUDIA TENNEY, R-N.Y.
repsthanedar	Rep. SHRI THANEDAR, D-Mich.
repbthompson	Rep. BENNIE G. THOMPSON, D-Miss.
repgthompson	Rep. GLENN THOMPSON, R-Pa.
repmthompson	Rep. MIKE THOMPSON, D-Calif.
repttiffany	Rep. THOMAS P. TIFFANY, R-Wis.
repwtimmons	Rep. WILLIAM R. TIMMONS IV, R-S.C.
repdtitus	Rep. DINA TITUS, D-Nev.
reprtlaib	Rep. RASHIDA TLAIB, D-Mich.
repjtokuda	Rep. JILL N. TOKUDA, D-Hawaii
repptonko	Rep. PAUL TONKO, D-N.Y.
repntorres	Rep. NORMA J. TORRES, D-Calif.
reprtorres	Rep. RITCHIE TORRES, D-N.Y.
repltrahan	Rep. LORI TRAHAN, D-Mass.
repdtran	Rep. DEREK TRAN, D-Calif.
repmturner	Rep. MICHAEL R. TURNER, R-Ohio
replunderwood	Rep. LAUREN UNDERWOOD, D-Ill.
repdvaladao	Rep. DAVID G. VALADAO, R-Calif.
repjvandrew	Rep. JEFFERSON VAN DREW, R-N.J.
repbvanduyne	Rep. BETH VAN DUYNE, R-Texas
repdvanorden	Rep. DERRICK VAN ORDEN, R-Wis.
repjvargas	Rep. JUAN VARGAS, D-Calif.
repgvasquez	Rep. GABE VASQUEZ, D-N.M.
repmveasey	Rep. MARC A. VEASEY, D-Texas
repnvelázquez	Rep. NYDIA M. VELÁZQUEZ, D-N.Y.
repevindman	Rep. EUGENE SIMON VINDMAN, D-Va.
repawagner	Rep. ANN WAGNER, R-Mo.
reptwalberg	Rep. TIM WALBERG, R-Mich.
repdwassermanschultz	Rep. DEBBIE WASSERMAN SCHULTZ, D-Fla.
repmwaters	Rep. MAXINE WATERS, D-Calif.
repbwatsoncoleman	Rep. BONNIE WATSON COLEMAN, D-N.J.
reprweber	Rep. RANDY K. WEBER SR., R-Texas
repdwebster	Rep. DANIEL WEBSTER, R-Fla.
repbwesterman	Rep. BRUCE WESTERMAN, R-Ark.
repgwhitesides	Rep. GEORGE WHITESIDES, D-Calif.
reptwied	Rep. TONY WIED, R-Wis.
repnwilliams	Rep. NIKEMA WILLIAMS, D-Ga.
reprwilliams	Rep. ROGER WILLIAMS, R-Texas
repfwilson	Rep. FREDERICA S. WILSON, D-Fla.
repjwilson	Rep. JOE WILSON, R-S.C.
reprwittman	Rep. ROBERT J. WITTMAN, R-Va.
repswomack	Rep. STEVE WOMACK, R-Ark.
repryakym	Rep. RUDY YAKYM III, R-Ind.
reprzinke	Rep. RYAN K. ZINKE, R-Mont.
